0000000000000000
0000000000000000
1111110000111111
0000000000000000
0000000000000000
0000111111110000
1100000000000011
0000000110000000
0000000000000000
1111110000111111
0000000000000000
0000000000000000
1111111111111111
