3333333223333333
0000000220000000
0000000220000000
2303030220303032
0000000000000000
0000000000000000
2323233003323232
0000000000000000
0000000000000000
2332003333002332
2000000000000002
2000000000000002
2222222222222222
