2222222222222222
0000000220000000
0000000220000000
2202020220202022
0000000000000000
0000000000000000
2222222002222222
0000000000000000
0000000000000000
2222002222002222
2002000000002002
2002000000002002
2222222222222222
